6 6
0 0
4 1
S _ _ _ _ _
_ _ X _ _ _
_ _ X _ _ _
_ _ X _ _ _
_ _ X _ E _
_ _ _ _ _ _
